-----------------------------------------------------------------------------------------------------------------------------------------------------------------------------------------------------------------f
-----------------------------------------------------------------------------------------------------------------------------------------------------------------------------------------------------------------f
---------------bb-------------------bbbb-------------------------------------------------------------------------------------------------------------------------------------------------------------------------f
---------------bb--------------------bb--------------------------------------------------------------------------------------------------------------------------------------------------------------------------f
---------------bb--------------------bb--------------------------------------------------------------------------------------------------------------------------------------------------------------------------f
---------------bb--------------------bb--------------------------------------A---bb--------------bbbb-----------------------------------------------bbbbb-----bbbbb---------b----A---------------------b---------f
-------------------------------------bb-----------------------------------A--A---bb---------------bb-----------------------------------------------b-----------bb---------------bb-------------------------------f
----------------A--------------------bb------------------------------------------bb---------------bb------------------------A---------------------bb-----------bb---------------bb-----------------A-------------f
---------------A---------------------bb--------------------------------A---------bb---------------bb---------------------------------------------bbb-------b---bb---------A-----bb----------------bb-------------f
--------------bb---bbbbbbbbbbbbbbbb--bb-------b----------------------------------bb---------------bb-----------------------b---b----------------bbbb-----------bb--------bb-----bb------------b---bb-------------f
--------------bb------------------------------b----------------------------------bb-----M---------bb-----------A---------------------------------------------------------bb-----bb----------------bb-------------f
--------------bb--------------------------A---b-----------------------------------------b---------------------bb-b-b---------------------A----------------------A--------bb-----bb----------------bb-------------f
---s----------bb-----------------------------Ab-------------------b---------------A-----M----------A----------bb-b-b--------------------A-------M------------M-----------bb-----bb------A---------bb------------bf
bbbbbbbbbbbbbbbbbbbbbbbbbAAbbbbbAbAbbbbbbbbbbbb-----bbAbbbbbbbbbbbb-------------bbbbbbbbbbbbbbbbbbbbbbbbAbbbbbbbbbbb-------------bbbbbbbbbbbbbbbbbbbbbbbbbbbbb-bbbbbbbAbbbb-----bbbbbbbbbbbbbbb---bbbbbbb-------bf
bbbbbbbbbbbbbbbbbbbbbbbbbbbbbbbbbbbbbbbbbbbbbbb-----bbbbbbbbbbbbbbb-------b-----bbbbbbbbbbbbbbbbbbbbbbbbbbbbbbbbbbbb-------------bbbbbbbbbbbbbbbbbbbbbbbbbbbbb-bbbbbbbbbbbb-----bbbbbbbbbbbbbbb---bbbbbbb-------bf