                           $       
b                          $      b
b                          $      b
b                          $      b
b                          $      b
b                          b      b
b                          b      b
b                         bbb     b
b                         bbb     b
b s                A     bbbbb B fb
bbbbbbbbbbbbbbbbbbbbbbbbbbbbbbbbbbb
