bbbbb---------------------------------------------
b-------------------------------------------------
b-------------------------------------------------
b-------------------------------------------------
b-------------------------------------------------
b-------------------------------------------------
b-------------------------------------------------
b-------------------------------------------------
b-------------------------------------------------
b-------------------------------------------------
b-------------------------------------------------
b-------------------------------------------------
b-------------------------------------------------
b-------------------------------------------------
b-------------------------------------------------
b-------------------------------------------------
b-------------------------------------------------
b-------------------------------------------------
b-------------------------------------------------
b-------------------------------------------------
b-------------------------------------------------
b-------------------------------------------------
b-------------------------------------------------
b-------------------------------------------------
b-------------------------------------------------
b-------------------------------------------------
b-------------------------------------------------
b-------------------------------------------------
b---------$$$$$$$---------------------------------
b------------------------------------------------f
b----$$$$----------------------------------------f
b---------bbbbbbb--------------------------------f
b------------------------------------------------f
b----bbbb----------------------------------------f
b----------$$$$$$$$$$$$$$$$$$$$$$$---------------f
b----------$$$$$$$$$$$$$$$$$$$$$$$----------M----f
b---bbb------------------------------------Mb----f
b---bbb-----------------------------------Mbb----f
b-s-bbb----------------D------D----------Mbbb-C--f
bbbbbbbbbbbbbbbbbbbbbbbbbbbbbbbbbbbbbbbbbbbbbbbbbb
b-------------------------------------------------
b-------------------------------------------------
b-------------------------------------------------
b-------------------------------------------------
b-------------------------------------------------
b-------------------------------------------------
b-------------------------------------------------
b-------------------------------------------------
b-------------------------------------------------
b-------------------------------------------------
b-------------------------------------------------
b-------------------------------------------------
b-------------------------------------------------
b-------------------------------------------------
b-------------------------------------------------
b-------------------------------------------------
b-------------------------------------------------