bbbbb----------------------------------------------------------------------------
b--------------------------------------------------------------------------------
b--------------------------------------------------------------------------------
b--------------------------------------------------------------------------------
b--------------------------------------------------------------------------------
b--------------------------------------------------------------------------------
b--------------------------------------------------------------------------------
b--------------------------------------------------------------------------------
b--------------------------------------------------------------------------------
b--------------------------------------------------------------------------------
b--------------------------------------------------------------------------------
b--------------------------------------------------------------------------------
b--------------------------------------------------------------------------------
b--------------------------------------------------------------------------------
b--------------------------------------------------------------------------------
b--------------------------------------------------------------------------------
b--------------------------------------------------------------------------------
b--------------------------------------------------------------------------------
b--------------------------------------------------------------------------------
b--------------------------------------------------------------------------------
b-----------------------------------------------------------------------------f--
b-----------------------------------------------------------------------------f--
b-----------------------------------------------------------------------------f--
b---------------W-------------------------------------------------------------f--
b---------------bW------------------------------------------------------------f--
b---------------bbW-----------------------------------------------------------f--
b---------------bbbW----------------------------------------------------------f--
b-------W-------bbbb----------------------------------------------------------f--
bbbbbbbbbbbbbbbbbbbb----------------------------------------------------------f--
bW----------------------------------------------------------------------------f--
bW----------------------------------------------------------------------------f--
bW-----------$$$$$$$$$$$$$$---------------------------------------------------f--
b------------$$$$$$$$$$$$$$---------------------------------------------------f--
b-----------------------------------------------------------------------------f--
b-----------------------------------------------------------------------------f--
bbbbb--------bbbbbbbbbbbbbbb-------bb--$$$------------$$$$$$$-----------------f--
b----------bbb-----------------bb---b--$$$---bb---bbb-$$$$$$$-----------------f--
b-----------------------------MMb---bb-$$$------------------------------------f--
b-s-------------------------DMMMb------$$$-bb--bb-----------C-------------M---f--
bbbbbbb--bbbbbbbbbbbbbbbbbbbbbbbb--------------------bbbbbbbbb-----------bbbbbb--
bW-------------------------------------bbbb------------------b-------------------
bbW----------------------------------------------------------bb------------------
bbbW--------------------------------------------------------------------bb-------
bbbbW----------------------------------------------------------------------------
bbbbb----------------------------------------------------------bb-----------bb---
b---------------------------------------------------------------bbb--bb----------
b----------------------------------------------------------------------$$$$$$$---
b--------------------------------------------------------$$$-------$$$$$$$$$---bb
b--------------------------------------------------------$$$-bb--$$$$$$$$$-------
b--------------------------------------------------------$$$-----$$$$$------bb---
b------------------------------------------------------------$$$$$$$$$-bbb-------
b--------------------------------------------------------bbb-$$$$$$--------------
b-------------------------------------------------------------------bb-----------
b--------------------------------------------------------------------------------
b------------------------------------------------------------bb--bb--------------
b--------------------------------------------------------------------------------
b--------------------------------------------------------------------------------