bbbbb--------------------------------------------------------
b------------------------------------------------------------
b------------------------------------------------------------
b------------------------------------------------------------
b------------------------------------------------------------
b------------------------------------------------------------
b------------------------------------------------------------
b------------------------------------------------------------
b------------------------------------------------------------
b------------------------------------------------------------
b------------------------------------------------------------
b------------------------------------------------------------
b------------------------------------------------------------
b------------------------------------------------------------
b------------------------------------------------------------
b------------------------------------------------------------
b------------------------------------------------------------
b------------------------------------------------------------
b------------------------------------------------------------
b------------------------------------------------------------
b-----------------------------------------------------------f
b-----------------------------------------------------------f
b-----------------------------------------------------------f
b-----------------------------------------------------------f
b-----------------------------------------------------------f
b-----------------------------------------------------------f
b-----------------------------------------------------------f
b-----------------------------------------------------------f
b-----------------------------------------------------------f
b-----------------------------------------------------------f
b-----------------------M--------------bbbb-----------------f
bW-----------$$$$$-bbbbbb--------------b$$$-----------------f
bbW-----------------------------------bb$$$-----------------f
bbbW----------------$$$---------------bb$$$-----------------f
bbbb--$$$$$$-bbbbb--$$$--------------bbb-A-------$$$$$$$$$$-f
b-------------------$$$---$$$$$$-----bbbbbb------------$$$$-f
b------A-A----------------$$$$$$----bbbb$$$-------A-A-------f
b-----bbbbbb--------bbb------------bbbbb$$$------bbbbb------f
b-s--------------------------D----bbbbbb-A--M-A------b--D---f
bbbbb--------------------bbbbbbbbbbbbbbbbbbbbbbb-----bbbbbbbf
bbW---------bbbbb-$$$$$--b-----------------------------------
bbbW--------------$$$$$--b-----------------------------------
bbbbW--------------------b-----------------------------------
bbbbb--------------A-----b-----------------------------------
b----------bbbbbbbbbbbb--b-----------------------------------
b----------b-$$$$$$$$----b-----------------------------------
b----------b-$$$$$$$$----b-----------------------------------
b----------b-$$$$$$$$-bbbb-----------------------------------
b----------b----------b$$b-----------------------------------
b----------b----A--A--b$$b-----------------------------------
b----------b---bbbbbbbb$$b-----------------------------------
b----------bb----$$$$$$--b-----------------------------------
b----------bbb---$$$$$$-Mb-----------------------------------
b----------bbbb--$$$$$$-Mb-----------------------------------
b----------bbbbb--------Mb-----------------------------------
b----------bbbbbb-------Mb-----------------------------------
b----------bbbbbbbbbbbbbbb-----------------------------------