bbbbb----------------------------------------------------------
b--------------------------------------------------------------
b--------------------------------------------------------------
b--------------------------------------------------------------
b--------------------------------------------------------------
b--------------------------------------------------------------
b--------------------------------------------------------------
b--------------------------------------------------------------
b--------------------------------------------------------------
b--------------------------------------------------------------
b--------------------------------------------------------------
b--------------------------------------------------------------
b--------------------------------------------------------------
b--------------------------------------------------------------
b--------------------------------------------------------------
b--------------------------------------------------------------
b--------------------------------------------------------------
b--------------------------------------------------------------
b--------------------------------------------------------------
b--------------------------------------------------------------
b-------------------------------------------------------------f
b-------------------------------------------------------------f
b-------------------------------------------------------------f
b-------------------------------------------------------------f
b-------------------------------------------------------------f
b----------------------bbbbbbbbbbbbbbb------------------------f
b----------------------b--$$$$$$$$$--b------------------------f
b----------------------b--$$$$$$$$$--b------------------------f
b----------------------b--$$$$$$$$$--b------------------------f
b----------------------b-------------b------------------------f
b----------------------b--bbbbbbbbb--b-------------------b----f
bW---------------------b--$$$$b$$$$--b------------------------f
bbW--------------------bb-$$$$b$$$$-bb----------------b-------f
bbbW--$$$$$$--------------$$$$b$$$$-------$$$$$$--------------f
bbbb----------$$$$$$$$$-------b---------------------b---------b
b------A-A----$$$$$$$$$---bbbbbbbbbb-------A-A--------------Mbb
b----bbbbbbb------------bbb----$$$$b-----bbbbbbbbbb-$$$$---Mbbb
b-----------------------------$$$$$b--------------b-$$$$--Mbbbb
b-s------------------D----$$$$$$$$$b--------------b-$$$$-Mbbbbb
bbbbb----bbbbbbbbbbbbbbbb-$$$$$---bbbbbbb---------b------bbbbbb
bW----------------------b-$$$$--bbb---------------bbbbbbbb-----
bbW---------------------b-$$$--bb------------------------------
bbbW--------------------b-----bbb------------------------------
bbbb--------------------bb---bbb-------------------------------
b------------------------bbbbb---------------------------------
b--------------------------------------------------------------
b--------------------------------------------------------------
b--------------------------------------------------------------
b--------------------------------------------------------------
b--------------------------------------------------------------
b--------------------------------------------------------------
b--------------------------------------------------------------
b--------------------------------------------------------------
b--------------------------------------------------------------
b--------------------------------------------------------------
b--------------------------------------------------------------
b--------------------------------------------------------------