bbbbb--------------------------------------------------------
b------------------------------------------------------------
b------------------------------------------------------------
b------------------------------------------------------------
b------------------------------------------------------------
b------------------------------------------------------------
b------------------------------------------------------------
b------------------------------------------------------------
b------------------------------------------------------------
b------------------------------------------------------------
b------------------------------------------------------------
b------------------------------------------------------------
b------------------------------------------------------------
b------------------------------------------------------------
b------------------------------------------------------------
b------------------------------------------------------------
b------------------------------------------------------------
b------------------------------------------------------------
b------------------------------------------------------------
b------------------------------------------------------------
b------------------------------------------------------------
b------------------------------------------------------------
b------------------------------------------------------------
b------------------------------------------------------------
b-----------------------------------------------------------f
b-----------------------------------------------------------f
bW--$$$-----------------------------------------------------f
bW--$$$-----------------------------------------------------f
bW--$$$-$$$-------------------------------------------------f
bW------$$$-------------------------------------------------f
bW------$$$-------------------------------------------------f
bW--bbb-------------------------$$$$$$-----M----------------f
bW------------------------------$$$$$$----Mb----------------f
b-------bbb------------------------------Mbb----------------f
b-------------------------------bbbbbb--bbbb--$$$$$$$$$$$$$-f
b---------------$$$$$$$$$$$$----b-------------$$$$$$$$$$$$$-f
b----------Mb---$$$$$$$$$$$$--bbb---------------------------f
b---------Mbb-----------------------------------------------f
b-s------Mbbb-----C------------------------------D-D----D---f
bbbbbbb--bbbb--bbbbbbbbbbbbbbb--------------bbbbbbbbbbbbbbbbf
b------------------------------------------------------------
b------------------------------------------------------------
b------------------------------------------------------------
b------------------------------------------------------------
b------------------------------------------------------------
b------------------------------------------------------------
b------------------------------------------------------------
b------------------------------------------------------------
b------------------------------------------------------------
b------------------------------------------------------------
b------------------------------------------------------------
b------------------------------------------------------------
b------------------------------------------------------------
b------------------------------------------------------------
b------------------------------------------------------------
b------------------------------------------------------------
b------------------------------------------------------------